
      25,
      19,
        38, 38, 38, 38, 38, 38, 38, 38, 38, 38, 38, 38, 38, 38, 38, 38, 38, 38, 38, 38, 38, 38, 38, 38, 38,
        38, 38, 38, 38, 38, 38, 38, 38, 38, 38, 38, 38, 38, 38, 38, 38, 38, 38, 38, 38, 38, 38, 38, 38, 38,
        38, 38, 0, 38, 0, 38, 0, 38, 38, 0, 0, 38, 38, 0, 0, 38, 38, 0, 0, 38, 38, 0, 0, 38, 0,
        0, 0, 0, 38, 0, 0, 0, 38, 0, 0, 0, 38, 0, 0, 0, 38, 0, 0, 0, 38, 0, 0, 0, 38, 0,
        0, 0, 0, 38, 0, 0, 0, 38, 0, 0, 0, 38, 0, 0, 0, 38, 0, 0, 0, 38, 0, 0, 0, 38, 0,
        2, 2, 2, 38, 2, 2, 2, 38, 2, 2, 0, 38, 2, 2, 0, 38, 2, 2, 2, 38, 2, 2, 0, 38, 2,
        0, 0, 0, 0, 0, 0, 0, 0, 0, 0, 0, 0, 0, 0, 0, 0, 0, 0, 0, 0, 0, 0, 0, 0, 0,
        38, 0, 0, 0, 0, 0, 0, 0, 0, 0, 0, 0, 0, 0, 0, 0, 0, 0, 0, 0, 0, 0, 0, 0, 0,
        38, 0, 0, 38, 38, 38, 38, 38, 38, 38, 38, 38, 38, 0, 38, 38, 38, 38, 38, 38, 38, 38, 38, 38, 38,
        38, 0, 0, 38, 38, 38, 38, 38, 0, 0, 0, 38, 38, 0, 38, 38, 0, 0, 0, 0, 0, 0, 0, 0, 0,
        38, 0, 0, 38, 38, 38, 38, 38, 0, 0, 0, 38, 38, 0, 0, 38, 0, 0, 0, 0, 0, 0, 0, 0, 0,
        38, 0, 0, 38, 0, 0, 38, 38, 0, 0, 0, 38, 0, 0, 0, 38, 0, 0, 0, 0, 0, 0, 0, 0, 0,
        38, 0, 0, 38, 0, 0, 0, 38, 0, 0, 0, 38, 0, 0, 0, 38, 0, 0, 0, 0, 0, 0, 0, 0, 0,
        38, 0, 0, 38, 2, 2, 2, 38, 0, 0, 0, 38, 0, 0, 0, 38, 0, 0, 0, 0, 0, 0, 0, 0, 0,
        38, 0, 0, 0, 0, 0, 0, 38, 0, 0, 0, 38, 0, 0, 0, 38, 0, 0, 0, 0, 0, 0, 0, 0, 0,
        38, 0, 0, 0, 0, 0, 0, 38, 0, 0, 0, 38, 0, 0, 0, 38, 0, 0, 0, 0, 0, 0, 0, 0, 0,
        38, 38, 38, 38, 38, 38, 38, 38, 0, 0, 0, 38, 0, 0, 0, 38, 0, 0, 0, 0, 0, 0, 0, 0, 0,
        0, 0, 0, 0, 0, 0, 0, 0, 0, 0, 0, 38, 0, 0, 0, 38, 0, 0, 0, 0, 0, 0, 0, 0, 0,
        0, 0, 0, 0, 0, 0, 0, 0, 0, 0, 0, 38, 0, 0, 0, 38, 0, 0, 0, 0, 0, 0, 0, 0, 0